F 85, 107, 47
C 135, 206, 235
NO images/walls/wall1_other.xpm
EA images/walls/wall3_other.xpm
WE images/fun/bidoof.xpm
SO images/walls/wall4_other.xpm
DO images/fun/door.xpm

11111111111111111111111111111111111111111111111111111111111
10000000000000000000000000000000000000000000000000000000001
10000000000000000000000000000000000000000000000000000000001
10010001111101111100000100000000001000010010010010010010011
10010001001001001100000100000000001000010010010010010010011
10010001001001001100000100000000001000010010010010010010011
10010001001001000100000100000000001000010010010010010010011
10010001001001001100000100000000001000010010010010010010011
10010001001001001100000100000000001000010010010010010010011
10000000000000000000000000000000000000000000000000000000001
10000000000000000000000000000000000000000000000000000000001
10010001001001000100000100000000001000010010010010010010011
100100010010010001N0000100000000001000010010010010010010011
11111001001001000100000100000000001000010010010010010010011
10010001001001000100000100000000001000010010010010010010011
10010001001001000100000100000000001000010010010010010010011
10010001001001000100000100000000001000010010010010010010011
10011111111001000110010101000100101000010010010010010010011
10011001001001000110010101000100101000010010010010010010011
10011001001001000110010101000100101000010010010010010010011
10011001001001000110010101000100101000010010010010010010011
10011001001001000110010101000100101000010010010010010010011
10011111111001000110010101000100101000010010010010010010011
11111111001000110010101000100101000010010010010010010011111
11111111001000110010101000100101000010010010010010010011111
11111111001000110010101000100101000010010010010010010011111
11111111001000110010101000100101000010010010010010010011111
11111111001000110010101000100101000010010010010010010011111
11111111001000110010101000100101000010010010010010010011111
11111111001000110010101000100101000010010010010010010011111
11111111001000110010101000100101000010010010010010010011111
11111111001000110010101000100101000010010010010010010011111
11111111001000110010101000100101000010010010010010010011111
11111111001000110010101000100101000010010010010010010011111
11111111001000110010101000100101000010010010010010010011111
10000000000000000000000000000000000000000000000000000000001
10000000000000000000000000000000000000000000000000000000001
10000000000000000000000000000000000000000000000000000000001
11111111111111111111111111111111111111111111111111111111111