F 85, 107, 100
C 135, 206, 235
NO images/fun/bidoof.xpm
EA images/fun/mario.xpm
WE images/fun/ness.xpm
SO images/fun/kirby.xpm
DO images/fun/doorMario64.xpm

11111111111111111111111111111111111111111111
10000000000000000000000000000000000000000001
10000000000000000000000000000000000000000001
100000011111D1111100000000011111110000000001
10000001000000000100000000001000010000000001
10000001000000000100000000001000010000000001
1000000D00000000D00000000000100001000W00001
10000001000000000100000000001000010000000001
10000001000000000100000000001000010000000001
1000000DDDDDDDDDDD00000000001111111000000001
10000000000000000000000000000000000000000001
10000000000000000000000000000000000000000001
1000000000000000000000000000000000000000001
11111000000000000000000000000000000000001111
10000000000000000000000000000000000000000001
10000000000000000000000000000000000000000001
10000000000000000000000000000000000000000001
10001111111000000000000000000111111110000001
10001000001000000000000000000000000100000001
1000100000D00000000000000000010000010000001
1000100000100000000000000000010000010000001
1000100000100000000000000000010000010000001
1000111111100000000000000000011111110000001
10000000000000000000000000000000000000000001
10000000000000000000000000000000000000000001
11111111111111111111111111111111111111111111
