F 85, 107, 100
C 135, 206, 235
NO images/fun/bidoof.xpm
EA images/fun/mario.xpm
WE images/fun/ness.xpm
SO images/fun/kirby.xpm
DO images/fun/doorMario64.xpm

11111111
11111111
10000001
11110111
111D0111
11000001
100W0001
10000001
11000001
11110111
11100011
10000001
11111111
