F 85, 107, 47
C 135, 206, 235

NO images/walls/wall1_other.xpm
EA images/walls/wall3_other.xpm
WE images/walls/wall2_other.xpm
SO images/walls/wall4_other.xpm

DO images/fun/door.xpm


1111111111111111111111111111111111111111
1000000000000000000000000000000000000001
1000000000000000000000000000000000000001
100000011111D111100000000011111110000001
1000000100000000100000000010000010000001
1000000100000000100000000010000010000001
1000000D00000000D00000000010000010000001
1000000100000000100000000010000010000001
1000000100000000100000000010000010000001
1000000111111D11100000000011111110000001
1000000000000000000000000000000000000001
1000000000000000000000000000000000000001
100000000000000000N000000000000000000001
1111100000000000000000000000000000001111
1000000000000000000000000000000000000001
1000000000000000000000000000000000000001
1000000000000000000000000000000000000001
1000111111100000000000000000011111100001
1000100000100000000000000000000000100001
1000100000D00000000000000000100000100001
1000100000100000000000000000100000100001
1000100000100000000000000000100000100001
1000111111100000000000000000111111100001
1000000000000000000000000000000000000001
1000000000000000000000000000000000000001
1000000000000000000000000000000000000001
1111111111111111111111111111111111111111
