F 85, 107, 100
C 135, 206, 235

NO images/fun/bidoof.xpm
EA images/fun/mario.xpm
WE images/fun/ness.xpm
SO images/fun/kirby.xpm
DO images/fun/doorMario64.xpm

11111111111111111111111111111
1111111110110000011100D000001
1000000000110000011101D111111
11110111111111011100000010001
11110111111111011101010010001
11000000110101111100000010001
100000000000000D0000000010001
10000000000000010000E00010001
1100000111010101111101111000111
11110111 1110101 101111010001
11111111 1111111 111111111111
